WWWWWWWWWWWWWWWWWWW
W    K     WWW    W
W    L   ~~WW     W
W       ~~S B     W
WWWWWWWWWWWWWWWWWWW

